Gene1	Gene2	Overlapped amino acid seq1	Overlapped amino acid seq2
AMDHD2	CEMP1	HPISVILPSSVSPWPWHTPMWQTRAVRLPEQLRGGWASGALLALRTATVGSDVRDWCSPTSGVIVLTFSPFEFWGGWLPSPLLTGAVLGTGGTRLALPLFSSLCCKAQLRKCLQVQRDRMVWAPPVGREQPGKNHLPGQGLA	QARPCPGRWFFPGCSLPTGGAQTILSLWTWRHFLNWALQQREENSGRARRVPPVPRTAPVSKGEGSHPPQNSNGEKVKTITPDVGLHQSLTSDPTVAVLRAKRAPEAHPPRSCSGSLTARVCHMGVCQGQGDTEDGRMTLMG
LBHD1	C11ORF98	AEEEAVQTPAGVESGAASEAPGGRGCDRPRADHAAPPQEAG	ELKKKLFKRRRVLNRERRLRHRVVGAVIDQGLITRHHLKKR
FAM120A	FAM120AOS	LAALAKACFGGNIELFVFFNGALEKARLHEWVKRQGNERQTAQQIVSHVQNKGTPPPKVWFLPPVCMAHCIRLALIRFHVK	LTWKRMSARRMQWAMQTGGRNQTFGGGVPLFWTWLTICCAVWRSLPCRLTHSCSRAFSSAPLKKTKSSMLPPKQALASAA
DUSP28	ANKMY1	PPLVRVAPSLFLGSARAAGAEEQLARAGVTLCVNVSRQQPGPRAPGVAELRVPVFDDPAEDLLAHLEPTCAA	MAAHVGSRCASRSSAGSSNTGTRSSATPGARGPGCWRETLTHSVTPARASCSSAPAARALPRKSEGATRTNGG
RANBP1	TRMT2A	MGSALGRARRTLSGRPFQRAPCKTRRALSLSAALRNVTKAQGGCPKSLVLWGCRPKRPRKRRTSLKLAWR	RHASFSDVRRFLGRFGLQPHKTKLFGQPPCAFVTFRSAAERDKALRVLHGALWKGRPLSVRLARPKADP
DDX27	ZNFX1	VILKFRDKIEKMEKDVYAVLQLEAEEKEMQQSEAQ	WASDCCISFSSASSCRTAYTSFSIFSILSRNLRMT
UBE2L3	RIMBP3C	MQVAAGTRGDTRLQEVALLPQLFDLLVLGQRRARLLRQVPSALAGKDLAQLQAGATLAGYRRAHGPE	LRAVSAPIPGESCAGLELCQVFARQRARDLSEQASAPLAKDKQIEELRQECHLLQARVASGPCSDLH
THRA	NR1D1	SLGVHPEGQQLLGMHVVQGPQVRQLEQQLGEAGSLQGPVLQHQSPKSPQQRLLELLHRSGILHARA	RSGMENSASVEQLQETLLRALRALVLKNRPLETSRFTKLLLKLPDLRTLNNMHSEKLLSFRVDAQ
RNF34	KDM2B	LTQFLQEFFFYLPKLDTHRHLGYELLTAFLGDLLAVPQVNMTDVSTAFEEGQALISDLIA	CNKVTDQCLSFFKRCGNICHIDLRYCKQVTKEGCEQFIAEMSVSVQFGQVEEKLLQKLS
PALD1	PRF1	ALASAEMLPWMPMLTWASTVRQSSTSLSVSPSRASSQVRRAVRADMRPPSSTARMKWVP	YGTHFIRAVELGGRISALTALRTCELALEGLTDNEVEDCLTVEAQVNIGIHGSISAEAK
AGPS	TTC30B	HEPHSTSTHHGRYRIPQICGRSFPPLDNFQDSSRFLPEPSTQECISPWFHHIHSLPF	KKAVNEYDETMEKYIPVLMAQAKIYWNLENYPMVEKIFRKSVEFCNDHDVWKLNVAHV
MRPL34	ABHD8	YFLSSGGAGSGSGRALGEGSGSQSRNSWSSVLTVSGHSSITMWLPSSMSFRNARSR	ILLLAFLKLIDEGSHMVMLECPETVNTLLHEFLLWEPEPSPKALPEPLPAPPEDKK
NME4	DECR2	WPSRRPTWRGTTVSPRTATSSARTCC	MAQPPPDVEGDDCLPAYRHLFCPDLL
CCNI2	SEPTIN8	QRNPSLHVASLTRQLQHCMAGHQLLQFKGSTLALVIITLELERLMPGWCAPISDL	RSDIGAHQPGMSLSSSKVMMTKASVEPLNCSSWWPAIQCCSCLVRDATWREGFL
FBXO16	ZNF395	GECPVPTPWKAVPPGSPGVGTQCLGGALGCPTLGATARRGRSPAFHHL	MASVLSRRLGKRSLLGARVLGPSASEGPSAAPPSEPLLEGAAPQPFTTS
KHNYN	CBLN3	WGARPASPDRFAVSAEAENKVREQQPHVERIFSVGVSVLPKDCPDNPH	MWGLSGQSFGRTLTPTLKMRSTWGCCSRTLFSASADTAKRSGDAGRAPQ
ZNF397	ZSCAN30	LSRPPKASSAIRWECVSPGSFPGDIIAAEATHSTISCFAINTLPAT	MVAGKVLMAKQEIVECVASAAMISPGKLPGETHSQRIAEEALGGLDN
TRAPPC4	SLC37A4	TQPSWTLGPSWCGCFVGGRRQPCWPHKSLQPPRRLCSNCSAWQWC	STIAKHYSWSTAFWVAEVICAASTAAFFLLRNIRTKMGRVSKKAE
TMEM213	KIAA1549	QLWKFCTVLCFWESRRSSSRIALMREAEEWPGWRSSVELVG	YPTSSTEDLQPGHSSASLIKAIREELLRLSQKQSTVQNFHS
UPK3BL2	POLR2J3	APEHISYVPQLSNDTLAGRLTLSTFTLEQPLGQFSSHNIS	CPRAHQLCAPALKRHLGGEAHPVHLHAGAASRPVQQPQHL
SERF2	SERINC4	YYAAVPAGWWGSGGGPATQPAAGGRWRFLHILGTQPQSH	SGSGAVYRVCAGTATFHLLQAVLLVHLHSPTSPRAQLHN
LEPROTL1	MBOAT4	GPDVCIGDISLLSRALTKLRPKARCVEEGVVQDPVGVV	YYSHWILDDSLLHAAGFGPELGQSPGEEGYVPDADIWT
CCDC24	SLC6A9	MLRHSPSLWELVEEHVPLRERREVKRILGEAAVDLSLE	LQAQVHRRLPQNPLHFASLPERNVLLHQLPQRGGVPEH
FADS2	FADS1	MTREPPGCRRVNSLMLYTLRSITSHRSSHPERWATSSQ	WDEVAQRSGCEERWLVIDRKVYNISEFTRRHPGGSRV
FAM187A	GFAP	LKAVPDVVSCGSRAVPRKLRTKARDHTPEVLVRSCLV	GTKQLRTSTSGVWSLALVRSFLGTALEPQDTTSGTAL
TBCE	TBCE	VLRCVAGCPGLEELYLESNNIFISE	CCGVSRGAQAWRNSTLSLTTFSFPK
ZNF575	ETHE1	SIEQPQPQLLDQLGIPRRCFQDWVDQNGLPGLSVTQQ	LLGDRESREAVLIDPVLETAPRDAQLIKELGLRLLYA
NELFCD	CTSZ	VLDVIAPPYTSDFVQLFLPILENDSIAGTIKTEGEHD	VMLAFRFDGTCDAVILQDGEEKLHEVRGIRRSNDVQH
GOLGA7B	CRTAC1	IEISIYEDRCSSGSSSSGSSSGSGSSSGGGGGAGAR	SPGPRPTTPTAAAATAAAAAAAGAATAAPVLVDGDLN
GNB3	CDCA3	ILSGHDNRVSCLGVTADGMAVATGSWDSFLKIWN	SVPDFEEAVPGTCGHSHPVSCDSQAAHPVIVARED
DUOXA2	DUOXA1	VLCLFLGGAVVSLQYVRPSALRTLLDQSAK	PWRFGPEGCEERWAEHTGDSPRPLRGRGTGR
ZBTB8A	ZBTB8OS	MSPSDGDKDSRWHLSEDENRSYVEIVEDGSAD	QQTHLLQSPHRIYSHLHSSAIWNPYLHLMGT
ATP2C1	ASTE1	VWLWERSGQQLVEIHPHLETGLPLTEDVSCV	LDTAHIFCQWQSCLQMGMYLNQLLSTPLPEPD
CISD2	SLC9B1	LLPFLGVLALLGYLAVRPFLPKKKQQKDSLIN	INQAILLLFLLREEWTNCKVAKKCEYTKERQ
TTC7A	MCFD2	LKVESELERCRAEGHWDRMPELVRQLQTLS	MLSVCSCRTSSGMRSQWPSARQRSSSLSTF
TSFM	AVIL	SQARNQPVKMGGSNPCLMIRIGVSGSRPL	PSGRDPDTPILIIKQGFEPPIFTGWFLAWD
MYOCOS	MYOC	MGSPSKFGKQELQLARTSVPGRPKCPNST	TWNLDTLAFQELKSELTEVPASRILKESP
COQ6	FAM161B	MRGQGPPLSSFGVWLASRAASDPSRPRRQ	LPPRAGWIGGCPGSQPDAKARKGWTLAPH
C22ORF39	HIRA	ASRFFQLIFTLTGPSSQLEDK	KPIFSVDIHPDGTKFATGGQ
MRPS22	COPB2	IDDATNLVQLYHVLHPDGQSAQGAKDQA	QPDPWPLEPTGHLDGARDTAGPSWLHHR
ZNF587	ZNF814	RVSQEPFVFREFGKDVLPSSGLCQEEA	QLLLGTILNWAERPSQTRGRQMAPVTP
RANGRF	SLC25A35	APWSLGDFEQLVTSLTLHDPNIFGPQ	LLGTKDVRIVKGQTGHQLFKVTQAPGC
OGG1	CAMK1	GLLGNAFDGHQLLRPLIFCQDHLREGP	GAFSEVILAEDKRTQKLVAIKCIAKEA
CHRNA5	CHRNA3	IAQVLDRMFLWTFLFVSIVGSLGLFV	EQKAQEIQQLKRKEKSTETSDQEPGL
RABEP1	NUP88	LKYREDIINVRTAADHVEEKLKAEILF	EKYLSLQLFFYVVCCCPHINDVLTVF
LRTOMT	TOMT	PPRLPVRAADRGAGLQLRAHPCPAR	LRDCLSGLRIEERAFSYVLTHALPG
SNRPF	CCDC38	IFIYILGILKQSKILLFQLSEDLK	LLQVLRELEEQNLTLFQYSQDVDEN
RAB3GAP1	ZRANB3	VLHYLAIQKPADLARHLLPCVIHA	LHESHKVTGAEQGLQVSGLPDSAA
C2	ZBTB12	MRALCIRETCSSELGFSRNWSRRK	FLRDQFLLNPSSELQVSLMHSAR
MTHFD1	ZBTB25	LALAQAVQRAAQAPSSFQLLYDLK	LEVIKELEAAGCLCCSLDGLSQG
UTP23	RAD21	LKTMKHLLSPFVPSSFFLILIAP	SGGDQDQEERRWNKRTQQMLHGLQ
GET1	LCA5L	DDGLIEFTTVTLESPKAWLVEA	QASTSHAFGDSKVTVVNSIKPSS
PRSS23	FZD4	IHQSVGTLLPRVKSFGRPNPHA	SGMWIWSAKTLHTWQKCSNRLVN
OPRM1	IPCEF1	PPLAVSMAQIFTRYPPPTHREK	FLTMSRRRISCKDLGHADCQGW
RINT1	EFCAB10	NEGGAAQLQFDMTRNLFPLFS	EKTKGKDSESYQTAAGLLLLH
WFDC13	WFDC10B	LCTMQEDCEKGFQCCSSFCGI	LSHRRRNSTEILSRNLPALYT
SEMA4G	MRPL43	GRASRAGGSAVQLQTVSGQC	DTGLRLSAVAPQILLPGWPDP
KRT18	KRT8	LDRVRSLETENRRLESKIRE	CSRILLSSLRFSVSRLLTLS
NDE1	MYH11	LDTSCRWLSKSTTRSSSSC	QQELDDLVVDLDNQRQLVSN
